XXXXXXXXXXXXXXXXXXXXXXXXXXXXXXXXXXXXXXXXXXXX
XX                                        XX
X                                          X
X                      2                   X
X                                          X
X        6            XXXX                 X
X                       XX                 X
X                                        XXX
X                                         XX
XXXXXXXXXXX                         3      X
X                                          X
X                                          X
X                                          X
X                                          X
X               XXX                      XXX
X      5         XX                      XXX
X                                         XX
X                                          X
X                                   1      X
X                                          X
X                                          X
X      7                                   X
X                                          X
X                                          X
X                        XX       XXXXXXXXXX
X                       XXX                X
X                      XXX                 X
X    0                                     X
X                                          X
X                   4                      X
X                                          X
X                                          X
XXXXXXXXXXXXXXXXXXXXXXXXXXXXXXXXXXXXXXXXXXXX