XXXXXXXXXX
X        X
X        X
X X     XX
X   S   XX
X        X
XXXXXXXXXX