XXXXXXXXXX
X        X
X        X
X X     XX
X       XX
X   S    X
XXXXXXXXXX