XXXXXXXXXXXXXXXXXXXXXXXXXXXXXXXXXXXXXXXXXXXX
XX                                        XX
X                                          X
X                                          X
X                                          X
X                     XXXX                 X
X                       XX                 X
X                                        XXX
X                                         XX
XXXXXXXXXXX                                X
X                                          X
X                                          X
X                                          X
X                                          X
X               XXX                      XXX
X                XX                      XXX
X                                         XX
X                                          X
X                                          X
X                                          X
X                                          X
X                                          X
X                                          X
X                                          X
X                        XX       XXXXXXXXXX
X                       XXX                X
X                      XXX                 X
X    S                                     X
X                                          X
X                                          X
X                                          X
X                                          X
XXXXXXXXXXXXXXXXXXXXXXXXXXXXXXXXXXXXXXXXXXXX